###############
#      @      #
#             #
#=#    #f   #=#
#a#        h#2#
#g#h        #g#
#a#        h#a#
#g#h   #    #g#
#1#        h#a#
###h   #    #=#
#e            #
#             #
#######=#######
#naraaaxaaraag#
###############
