###############
#@        aaa #
#############=#
#        h    #
#    aaa#    0#
# #############
# #ggg h ggg#v#
# #####       #
#v      ##### #
##      raaaa #
#h ############
# h          n#
#b        #####
#ggfgggggggggr#
###############
