###############
#             #
#  @          #
#             #
#  ##e    ##  #
#  ##e    ##  #
#  ##e    ##  #
#  ##e    ##  #
#  ##e    ##  #
#  ##eeeee##  #
#   #######   #
#             #
#   ggtargg   #
#           x #
###############
