###############
#             #
#  @          #
#             #
#  ########   #
#  eee##eee   #
#     ## e    #
#     ##e     #
#    e##      #
#  eee##eee   #
#  ########   #
#             #
#   ggartgg   #
#           x #
###############
