###############
#     x@aaaaa #
#h            #
#h            #
#v            #
# ##### ##### #
# =ggg# =ggg# #
# #r3a# #g2a# #
# #=### ###=# #
#      h     v#
#             #
#    v    h   #
#####=====#####
#gha   1   ahg#
###############
