###############
#             #
#  @          #
#  ###   ###  #
# #   # #   # #
# #    =    # #
# #  eeeee  # #
#  #   e   #  #
#   #e e  #   #
#    #ee #    #
#     # #     #
#      #      #
#   ggggggg   #
#           x #
###############
